32 18 80 300 maps/Map2.txt

0 0 0 0 0 0 0 0 0 0 0 0 0 0 0 0 0 0 0 0 0 0 0 0 0 0 0 0 0 0 0 0
2 2 2 73 2 2 2 2 2 2 0 0 0 0 0 0 0 0 0 0 0 0 0 0 0 0 0 0 0 0 0 0
2 5 1 1 1 1 1 1 1 2 0 0 0 0 0 0 0 0 0 0 0 0 0 0 0 0 0 0 0 0 0 0
2 1 1 1 1 1 1 1 1 2 0 0 0 0 0 0 0 0 0 0 0 0 0 0 0 0 0 0 0 0 0 0
2 1 1 1 1 82 1 1 1 2 0 0 0 0 0 0 0 0 0 0 0 0 0 0 0 0 0 0 0 0 0 0
2 1 1 1 1 1 1 1 1 2 0 0 0 0 0 0 0 0 0 0 0 0 0 0 0 0 0 0 0 0 0 0
2 8 1 1 1 1 1 1 1 2 0 0 0 0 2 2 2 2 2 2 2 2 2 2 72 2 2 2 2 2 0 0
2 1 1 1 1 1 1 1 1 2 0 0 0 0 2 1 1 3 1 1 1 1 1 3 1 1 1 1 1 2 0 0
2 1 1 1 1 1 1 1 1 2 0 0 0 0 2 1 1 3 1 1 3 1 1 3 1 1 1 1 1 2 0 0
2 1 1 1 1 1 1 3 1 2 0 0 0 0 2 1 1 3 1 1 3 1 1 3 1 1 1 1 1 2 0 0
2 1 1 1 1 2 2 2 1 2 2 2 2 2 2 1 1 1 1 1 3 1 1 3 1 1 1 1 1 2 2 2
2 1 1 1 1 2 0 2 1 1 1 3 1 1 1 1 1 3 1 1 3 1 1 3 1 1 1 1 1 1 1 2
2 1 1 1 1 2 0 2 2 2 1 1 1 1 1 1 1 3 1 1 3 1 1 1 1 1 1 1 1 1 1 2
2 1 1 1 1 2 0 0 0 2 2 2 2 2 2 2 72 2 2 2 2 2 2 2 2 2 2 2 2 1 1 2 
2 3 3 3 3 2 0 0 0 0 0 0 0 0 0 0 0 0 0 0 0 0 0 0 0 0 0 0 2 1 4 2
2 3 3 3 3 2 0 0 0 0 0 0 0 0 0 0 0 0 0 0 0 0 0 0 0 0 0 0 2 2 2 71
2 2 2 2 2 2 0 0 0 0 0 0 0 0 0 0 0 0 0 0 0 0 0 0 0 0 0 0 0 0 0 0
0 0 0 0 0 0 0 0 0 0 0 0 0 0 0 0 0 0 0 0 0 0 0 0 0 0 0 0 0 0 0 0
