32 30 500 200 maps/Map8.txt

0 0 0 0 0 0 0 0 0 0 0 0 0 0 0 0 0 0 0 0 0 0 0 0 0 0 0 0 0 0 0 0
2 2 2 2 2 2 72 2 2 2 2 2 2 2 2 72 2 2 2 2 2 2 72 2 2 2 2 2 2 2 0 0
2 1 1 1 1 1 1 1 1 1 1 1 1 8 1 1 1 1 1 1 1 1 1 5 1 1 1 1 1 2 0 0
2 1 1 1 1 1 1 1 1 1 1 1 1 1 1 1 1 1 1 1 1 1 1 1 1 1 1 1 1 2 0 0
2 1 1 1 1 1 1 1 1 1 1 1 1 1 1 1 1 1 1 1 1 1 1 1 1 1 1 1 1 2 0 0
2 1 1 1 1 1 1 1 1 1 1 1 1 1 1 1 1 1 1 1 1 1 1 1 1 1 1 1 1 2 0 0
2 1 1 1 1 1 1 1 1 1 1 1 1 1 1 1 1 1 1 1 1 1 1 1 1 1 1 1 1 2 0 0
2 2 2 2 2 2 1 2 2 2 2 2 2 1 2 2 2 2 2 2 1 2 2 2 2 2 2 1 2 2 0 0
2 0 0 0 0 2 1 2 0 0 0 0 2 1 2 0 0 0 0 2 1 2 0 0 0 0 2 1 2 2 0 0
2 0 0 0 0 2 1 2 0 0 0 0 2 1 2 0 0 0 0 2 1 2 0 0 0 0 2 1 2 2 0 0
2 0 0 0 0 2 1 2 0 0 0 0 2 1 2 0 0 0 0 2 1 2 0 0 0 0 2 1 2 2 0 0
2 0 0 0 0 2 1 2 0 0 0 0 2 1 2 0 0 0 0 2 1 2 2 2 2 2 2 1 2 2 0 0
2 1 2 2 2 2 1 2 1 1 1 1 2 1 2 1 1 1 1 2 1 1 1 1 1 1 2 1 2 2 0 0
2 1 2 1 1 1 1 2 1 1 1 2 2 1 2 2 2 2 1 1 2 1 1 2 1 1 2 1 2 2 0 0
2 1 2 1 2 2 2 2 1 1 2 1 1 1 2 1 1 1 2 1 2 1 2 1 1 1 2 1 2 2 0 0
2 1 2 1 2 1 1 1 1 1 2 1 2 2 1 1 2 1 2 1 1 2 1 1 2 2 2 1 2 2 0 0
2 1 2 1 2 2 2 1 1 1 2 1 1 1 1 2 2 1 2 1 1 2 1 2 1 1 1 1 2 2 0 0
2 1 2 1 1 1 2 1 1 1 1 2 2 2 2 1 2 1 2 1 1 2 1 2 1 2 2 2 1 2 0 0
2 1 2 1 2 1 2 1 1 1 1 1 1 1 1 1 2 1 2 1 1 2 1 1 1 2 1 2 1 2 0 0
2 1 2 1 1 1 1 1 1 1 1 1 1 1 1 1 2 1 2 1 1 1 2 2 2 1 2 1 1 2 0 0
2 1 2 1 2 1 1 1 1 1 1 1 1 1 1 1 2 1 2 1 1 1 1 1 1 1 1 2 1 2 0 0
2 1 2 2 2 1 1 1 1 1 1 1 1 1 1 1 2 2 2 1 1 1 1 1 1 1 1 2 1 2 2 0
2 1 1 1 1 1 1 1 1 1 1 1 1 1 1 1 1 1 1 1 1 1 1 1 1 1 1 2 1 2 1 2
2 1 1 1 1 1 1 1 1 1 1 1 1 1 1 1 1 1 1 1 1 1 1 1 1 1 1 2 1 2 1 2
2 1 1 1 1 1 1 1 1 1 1 1 1 1 1 1 1 1 1 1 1 1 1 1 1 1 1 1 1 1 1 2
2 1 1 1 1 1 1 1 1 1 1 1 1 1 1 1 1 1 1 1 1 1 1 1 1 1 1 1 1 1 1 2
2 1 1 1 1 1 1 1 1 1 1 1 1 1 1 1 1 1 1 1 1 1 1 1 1 1 1 1 1 1 1 2
2 1 1 1 1 1 1 1 1 1 1 1 1 1 1 1 1 1 1 1 1 1 1 1 1 1 1 1 1 1 1 2
2 1 1 1 1 1 1 1 1 1 1 1 1 1 1 1 1 1 1 1 1 1 1 1 1 1 1 1 1 4 1 2
2 2 2 2 2 2 72 2 2 2 2 2 2 2 2 72 2 2 2 2 2 2 72 2 2 2 2 2 2 2 2 2


