11 10 150 150 maps/test.txt

00 00 00 00 00 00 00 00 00 00 00
00 01 00 00 00 01 00 01 01 00 00
00 00 01 00 01 00 01 00 00 01 00
00 00 00 01 00 00 01 00 00 01 00
00 00 00 01 00 00 01 00 00 01 00
00 00 00 01 00 00 01 00 00 01 00
00 00 00 01 00 00 01 00 00 01 00
00 00 00 01 00 00 01 00 00 01 00
00 00 00 01 00 00 00 01 01 00 00
00 00 00 00 00 04 00 00 00 00 00