17 10 60 60 maps/test2.txt

2 73 2 2 81 02 2 2 2 2 2 2 2 2 2 2 2 
2 01 01 2 2 02 01 01 01 01 01 61 61 61 01 01 2
2 01 01 01 01 02 01 01 01 01 01 01 01 01 01 01 2 
2 01 01 01 01 02 01 01 01 01 01 62 62 62 01 01 2 
2 01 01 01 01 02 01 01 01 01 01 01 01 01 01 01 2
2 01 01 01 01 02 01 01 01 01 01 01 01 63 01 01 2 
2 01 01 01 01 02 02 02 02 01 01 01 01 01 01 01 2 
2 01 01 01 01 01 01 01 01 01 01 01 01 64 01 01 2
2 01 01 01 01 01 01 01 01 01 01 01 01 01 01 01 2
2 02 2 2 2 05 2 2 2 2 2 2 2 2 73 2 2